##########
#_____####
#_###_####
#_#__b_###
#_#_@@_b_#
#__b@@_#_#
###_b_p#_#
####_###_#
####_____#
##########
