##########
##########
##_____###
##b###___#
#_p_b__b_#
#_@@#_b_##
##@@#___##
##########
##########
##########
