##########
##########
####@#####
####_#####
####b_b@##
##@_bp####
#####b####
#####@####
##########
##########
