##########
#p__######
#_bb######
#_b_###@##
###_###@##
###____@##
##___#__##
##___#####
##########
##########
